1111111111111
1CC10000000C1
1100011111001
1P001CE0000X1
1010101010101
1CCC1CCC1CC11
1000000000111
1111111111111
