111111111
1E111XP11
10C0C0C01
111111111
