11111111
1010CX01
1E000P11
11111111
